ㄅㄚ	夫扶芙枎蚨砆玞趺撫敷賦赋輔浦蒲莆圃父巴把豝葩萉吧皅杷芭耙步膚釜滏布佈傅匍匐榑甫餔鯆䩉普镨譜鐠鈇斧脯黼簠哺捕補蒱逋酺痡晡鋪怖旉賻鄜鳺
ㄅㄚㄍ	白伯迫柏帕栢百竡魄拍砶珀怕粕胉碧䨣霸灞帛博猼欂薄泊縛簙礡搏鎛膊髆溥簿礴鑮亳
ㄅㄚㄥ	方肪芳髣㫄旁膀仿放舫房防彷滂謗榜彭病兵浜秉烹柄訪炳雱𠥓𥛱牥邡枋昉旊妨紡倣坊魴祊騯傍徬艕汸蒡匚丙怲昺邴棅輣
ㄅㄜ	不否桮嚭𧳏圮杯盃衃紑芣阫坏轡婦負駓邳丕伾秠胚銔坯鈈鉟柸魾陪倍踣偩萯
ㄅㄜㄍ	北富服菔伏茯洑備愎鄙譬壁嬖背鄁偝揹副褔奰邶僰畐福愊葍輻堛幅揊楅湢逼偪疈箙犕憊𠬝𤰇𩎧𣖾絥濞
ㄅㄜㄥ	冰憑馮朋棚倗傰硼弸鵬崩塴蹦繃掤凭凴
ㄅㄝ	卑萆俾陴牌錍郫佩珮埤碑裨鞞脾婢庳䫌鼙髀捭稗粺蜱崥蠯箄吡猈
ㄅㄝㄍ	辟薜鸊𪇊霹蘗檗擘襞繴臂擗闢避僻璧椑躃躄澼劈甓孹䌟釽𠂢派
ㄅㄝㄥ	平萍枰屏並屛恲頩駢坪評苹泙伻砰甹娉聘竝并餅鉼偋軿併洴缾瓶荓絣迸踫碰𨂝郱
ㄅㄛ	泭府捬附拊腑鳧腐剖抔㕻咅部哣蔀培菩棓瓿掊垘付柎咐跗怤軵俯符坿袝駙蚹鮒胕弣祔苻
ㄅㄛㄍ	僕樸璞瞨赴朴卜剝扑仆訃钋釙菐轐濮撲襆幞墣曝攵攴
ㄅㄛㄥ	丰封邦帮幫玤逢逄蓬蜂奉縫葑鞛琣琫唪菶蚌夆鋒锋峯摓烽鋒峰犎䋽捧俸棒蜯
ㄅㄨ	保堡褒寶蜉浮烰枹阝阜報包飽抱笣颮皰袍庖苞刨泡咆鮑瓟炮匏砲罦罘鴇缶裒滮孚稃脬琈葆褓裦虣髟彪胞䍖鞄俘莩郛垺桴殍捊
ㄅㄨㄍ	腹復雹覆蝮复輹複鰒澓
ㄅㄨㄥ	豐麷賵灃酆
ㄅㄚㄨ	表錶鑣㶾摽嘌飄麃儦瀌驫票熛僄慓嫖剽薸瓢穮皫犥蔈飆驃
ㄅㄚㄨㄍ	豹駮暴瀑嚗爆駁襮
ㄅㄚㄧ	彼披詖被波破碆簸婆罷羆擺播譒皤鄱頗颇跛陂皮鞁疲鈹帔坡
ㄅㄛㄧ	鉕
ㄅㄝㄉ	八蔽弊敝鼈別捌虌鱉拜幣斃獘嫳鷩蟞憋蹩睥獙
ㄅㄚㄉ	貝唄郥浿呗敗狽髮罰伐閥瞂傠發撥墢潑溌廢癈醗醱鏺沛肺拔吠鼣茷茇跋袚軷旆斾㤄魃癶襏癹犮胈坺筏鉢
ㄅㄛㄉ	-
ㄅㄝㄋ	片編褊甂翩萹偏篇鞭楩便箯辨辯㭊邊遍釆籩徧扁楄蹁猵惼諞辡辦辮
ㄅㄚㄋ	反翻藩嶓墦阪坂返繁煩薠飯眅軬昄判叛伴畔跘牉斑班盤攀抃扳板半版蘩泮袢弁槃蕃番幡僠燔磻樊頒颁拚般瘢靽絆姅拌頖胖柈搬磐縏鞶販畈鈑棥旛轓繙璠膰蹯潘籓䉒蟠卞犿汴笲肦瀿矾礬攽
ㄅㄛㄋ	變
ㄅㄧ	匕比仳阰沘庇陛牝紕妣毗膍貔朼疕庀秕粃枇鈚芘批屁蚍坒梐狴毘蓖篦箆
ㄅㄜㄧ	非菲排輩痱悲陫徘俳霏腓裴飛妃騑肥淝配斐翡匪扉誹棐篚悱剕厞屝蜚
ㄅㄨㄧ	-
ㄅㄧㄉ	必泌苾珌怭飶駜畢彃蓽韠匹閉蹕弼祕邲鉍罼毖畀痹痺𢌿閟觱淠⽦鴄鼻䫁㧙柲覕㪤篳縪弜疪糒
ㄅㄜㄉ	弗沸茀拂彿刜坲怫髴笰孛悖勃挬渤岪費鄪曊芾黻紼佛仏紱韍帗祓浡誖綍咈艴昲巿朏
ㄅㄨㄉ	狒
ㄅㄧㄋ	賓濱繽嬪嫔蘋盼鬢骿胼跰腁儐檳賔頻鑌擯殯摈矉髕臏蠙瀕嚬玭
ㄅㄜㄋ	分氛芬羒紛砏棻昐梤忿枌蒶蚠鼢雰糞瀵奮貧奔本墳憤濆膹汾妢蚡邠朌粉幩賁豳餴焚畚犇鼖噴歕獖饙僨羵蕡豶轒黂翂棼弅扮秎盆份彬斌坌
ㄅㄨㄋ	-
ㄅㄚㄅ	法乏灋砭鍅
ㄅㄚㄇ	氾汎犯範泛貶凡窆帆軓范梵諚
ㄅㄜㄅ	-
ㄅㄜㄇ	風风鳳楓颿芃品飌諷渢

ㄇㄚ	馬武無蕪嫵潕巫舞儛廡慕嫫謨憮甒譕幠膴鄦无鵡誣禡罵傌玛瑪駡螞蚂模蟆摸摹
ㄇㄚㄍ	莫鄚鏌暮寞漠陌絈佰嗼幕貊瘼暯膜募墓
ㄇㄚㄥ	亡忘芒茫莣妄望罔惘荒明盟萌橗莽漭莾孟猛網虻𦣠𧭅茻蟒鋩忙汒盲䖟蝱甿肓衁巟㡆㡛朢网罒蛧魍輞皿
ㄇㄜ	母毋每踇晦悔梅海鋂敏黴薶霾埋媒謀才脢賄痗脄誨某禖腜煤𠧩歾
ㄇㄜㄍ	麥黑墨默黙牧纆嘿
ㄇㄜㄥ	命鳴䳟黽鱦鄳鼆僶𪓑鼌夢萝梦鄸懵懜瞢薨甍蘉憫氓
ㄇㄝ	弭彌獼賣瀰渳麛羋買冞敉侎䍘
ㄇㄝㄍ	幦覓鼏簚糸糹脈霢覛塓冪䄙羃蓂
ㄇㄝㄥ	名怦冥瞑幎暝溟螟蓂銘
ㄇㄛ	畝怦騖務蓩𦎦霧艨雾拇侮姆畮𠔼敄婺
ㄇㄛㄍ	木沐鶩瞀坶楘霂
ㄇㄛㄥ	蒙矇濛懞庬厖痝尨饛幪哤駹蠓𢄐朦蛖佲酩茗
ㄇㄨ	茂矛茅袤繆壄謬蟊貿鄮牟昴牡戊冃帽媢瑁楙懋鍪蝥恈麰侔眸
ㄇㄨㄍ	目苜冒穆睦勖
ㄇㄨㄥ	-
ㄇㄚㄨ	毛貌苗貓媌描廟旄耄秒眇缈緲淼妙杪玅髦髳𩭾芼秏耗皃鈔渺
ㄇㄚㄨㄍ	邈藐眊
ㄇㄚㄧ	麻麾靡灖劘爢塺毀𣪷毁毇䃣糜釄醾蘼磨摩縻攠麼麽嬤嬷燬
ㄇㄛㄧ	-
ㄇㄝㄉ	滅蔑薎幭懱䁾篾烕搣
ㄇㄚㄉ	末沫妺枺粖邁秣抹韈韤襪䀛
ㄇㄛㄉ	-
ㄇㄝㄋ	面偭湎麵櫋旻麪沔臱䰓芇緬缅媔丏眄宀
ㄇㄚㄋ	免勉睌挽謾曼熳蔓漫慢滿萬万濿晚脕葂俛冕嫚僈墁幔縵鄤㒼瞞慲樠娩輓悗鞔
ㄇㄛㄋ	蠻蛮緜綿绵槾
ㄇㄧ	米迷粎麋眯謎瞇蘪
ㄇㄜㄧ	微火眉亹枚尾浼徽玫娓浘攗覹
ㄇㄨㄧ	美楣媚湄郿媺
ㄇㄧㄉ	實宓秘寐密蜜峚𥁑謐
ㄇㄜㄉ	物勿忽曶沒没歿未味昧眛沬妹韎芴昒惚笏魅鬽
ㄇㄨㄉ	-
ㄇㄧㄋ	民眠湣岷崏苠泯瑉祆啽
ㄇㄜㄋ	文抆閔芠紋闵門门們聞問悶閽昏痻捫惛焝懣汶婚璊穈絻吻呡刎脗䐇昬涽惽殙閩蚊蟁紊忞玟虋
ㄇㄨㄋ	愍吮緡珉抿缗緍㨉敃暋鋗
ㄇㄚㄅ	-
ㄇㄚㄇ	鋄
ㄇㄜㄅ	-
ㄇㄜㄇ	-

ㄋㄚ	女汝如恕怒茹洳袽帤鴽奴駑拏孥帑砮笯弩努挐拿嗱镎鎿黍籹鼠癙
ㄋㄚㄍ	若箬鄀諾婼喏惹
ㄋㄚㄥ	攘壤曩讓驤蘘鬤穰瀼穣禳釀饟囊躟
ㄋㄜ	而恧栭胹鴯鸸鮞耐陑陾𨼏耏聏耳珥駬餌衈刵佴洱刵佴咡眲咡眲恥耻栭聏胹鴯鮞輀轜迺乃鼐能態
ㄋㄜㄍ	匿嫟暱慝湼臸敕遫侙
ㄋㄜㄥ	仍扔艿芿能耎陾𨼏碝媆嫩礝
ㄋㄝ	爾邇嬭濔薾禰祢尔尒
ㄋㄝㄍ	疒
ㄋㄝㄥ	寕濘嬣儜寧寍甯佞檉蟶蛏
ㄋㄛ	濡嚅儒薷臑獳孺蠕醹需繻襦懦懧乳裳	
ㄋㄛㄍ	辱辱搙褥鎒鄏蓐溽縟槈耨
ㄋㄛㄥ	農襛儂憹噥癑侬穠禯濃醲茸氄宂冗寵
ㄋㄨ	柔葇鍒蝚糅猱蹂楺揉㽥輮丑紐纽狃杻鈕㺲杽夒腦硇
ㄋㄨㄍ	肉朒叔椒菽惄忸衄衂耨
ㄋㄨㄥ	戎娀茙農襛儂憹噥膿癑侬
ㄋㄚㄨ	淖獶擾呶怓惱腦嫋
ㄋㄚㄨㄍ	弱溺蒻愵搦搻尿
ㄋㄚㄧ	儺臡那旎
ㄋㄛㄧ	妥諉俀綏浽
ㄋㄝㄉ	熱勢設
ㄋㄚㄉ	柰奈渿女恕茹洳絮嘆
ㄋㄛㄉ	芮蜹焫枘蚋汭爇㨎擩
ㄋㄝㄋ	蹍撵肰名天跈
ㄋㄚㄋ	然撚燃難灘攤㸐戁歎煽㞋赧扇傓天跈
ㄋㄛㄋ	耎蝡瑌偄渜煗壖𤲬瓀輭軟奻
ㄋㄧ	尼泥埿怩柅昵呢檷
ㄋㄜㄧ	泥
ㄋㄨㄧ	餒緌蕤
ㄋㄧㄉ	日馹替圼涅䵒衵二貳膩樲泥
ㄋㄜㄉ	態螚餌耐肸
ㄋㄨㄉ	軏內㕯訥
ㄋㄧㄋ	人亻仁年名身
ㄋㄜㄋ	刃紉仭纫忍涊軔仞牣訒認綛垽猌憗彌瀰獼跈
ㄋㄨㄋ	閏潤犉𣯍
ㄋㄚㄅ	聶攝躡灄鑷囁讘懾踂苶捻敜
ㄋㄚㄇ	冉聃呥姌袡髯柟舑染拈黏鮎鲇袇广
ㄋㄜㄅ	入內納纳軜捻敜廿
ㄋㄜㄇ	南湳腩揇楠男侽壬任衽銋鵀荏探深念諗稔腍淰鯰鲶紝飪妊姙絍袵恁賃冄枏

ㄥㄚ	魚漁五吾梧浯語郚牾逜衙鋙敔伍圄齬啎捂午仵忤迕許滸圉牙齖芽庌訝雅御禦
ㄥㄚㄍ	屰㡿逆咢蕚萼鄂諤顎愕遌鍔卾腭鶚遻額頟詻噩蘁晤迓虩
ㄥㄚㄥ	卬迎仰昂
ㄥㄜ	疑擬觺儗癡痴薿騃
ㄥㄜㄍ	疑嶷礙懝䵑赩
ㄥㄜㄥ	凝
ㄥㄝ	兒睨鶃鯢晲堄誽唲倪棿齯猊婗貎輗郳觬麑掜儿厓崖崕涯啀睚
ㄥㄝㄍ	鬩鶂鷊鷁
ㄥㄝㄥ	-
ㄥㄛ	禺遇隅喁堣湡歶偶愚寓齵耦藕吴吳俁娛鋘悞悮虞麌
ㄥㄛㄍ	玉頊獄嶽鸑岳𩓥
ㄥㄛㄥ	顒
ㄥㄨ	翱翶牛牜
ㄥㄨㄍ	-
ㄥㄨㄥ	-
ㄥㄚㄨ	敖傲廒隞鏊嗷磝熬獒遨鼇嗸螯摮謷驁垚尭堯橈譊鐃燒蕘遶僥嬈憢鱙嶢襓饒蟯蛲撓挠翹翘繞绕嚻虈囂奡
ㄥㄚㄨㄍ	樂擽虐瘧謔
ㄥㄚㄧ	我蛾峨餓俄娥莪睋誐鵝義議檥儀鸃犧蟻犠巇羲宜誼
ㄥㄛㄧ	化吪訛貨譌偽僞伪瓦㧚臥卧危祪洈姽峗桅
ㄥㄝㄉ	埶熱蓺藝囈摰槷勢袃齧囓設蔎帠隉鎳镍臲闑孼櫱孽
ㄥㄚㄉ	乂刈艾歹歺孽櫱糵枿讞𣡌齾臬㓷悟語寤御馭
ㄥㄛㄉ	軏爇刖跀誤嵎吶
ㄥㄝㄋ	晛硯研硏妍姸揅
ㄥㄚㄋ	言訁這唁厂厈鬳顏顔彥彦喭獻甗雁鴈憲瀗諺巘犴豻
ㄥㄛㄋ	願騵邍
ㄥㄧ	詣
ㄥㄜㄧ	螘沂簿
ㄥㄨㄧ	魏巍繠蕊橤
ㄥㄧㄉ	劓
ㄥㄜㄉ	仡圪釳豙毅藙簿
ㄥㄨㄉ	兀扤杌阢聵
ㄥㄧㄋ	嚚
ㄥㄜㄋ	眼垠㙬銀鄞狺誾㬎
ㄥㄨㄋ	-
ㄥㄚㄅ	業鄴
ㄥㄚㄇ	險嶮驗噞顩嚴巖岩礹儼
ㄥㄜㄅ	吸岌圾儑
ㄥㄜㄇ	吟顉趛儑碞喦

ㄌㄚ	余艅狳鵌敘斜蜍畬悆予妤抒序野舒悇豫澦與輿轝礜舉擧譽舍菟緒餘徐馀漵塗冶虎淲處虙鯱傂杼書书捨旟兔暑奢茶涂途梌駼賒敍㻌稌預紓芧墅埜舁歟璵䑂鸒藇鱮与䖘耶揶衺琥擄
ㄌㄚㄍ	鐸凙赤赦斥席蓆射謝谢釋繹釈懌庶榭榭㡿柝厈螫睪嶧𢍰𥼶圛譯醳驛䁺斁殬蘀麝
ㄌㄚㄥ	陽揚傷殤湯蕩盪楊煬閶唐溏磄昌猖倡菖唱䱽鯧商𧶜颺觴塘榶螗𥏫昜暘旸瘍餳饧鍚禓璗簜愓碭
ㄌㄜ	以似姒苡㠯耜已台始邰殆詒诒貽鮐怡飴怠駘苔箈胎佁鈶炱紿嗣詞辭辤詩矣巳汜祀圯迨寺邿祠
ㄌㄜㄍ	弋代玳黓式飤飾餝試軾岱翼異食蚀𧐂飼黛异㚤杙忒貣貸蟘拭弒弑瀷廙翊蛡翌蝕
ㄌㄜㄥ	升陞勝騰稱爯偁媵蠅𣎜昇灷㑞賸滕縢螣塍孕抍剩
ㄌㄝ	遞豕翨虒嗁磃鼶舓栘
ㄌㄝㄍ	錫易狄悐惕賜踢蜴鬄啻褅𧝐荻蔐逖埸睗晹緆裼剔逷髢
ㄌㄝㄥ	繩澠盈楹筳庭娗聖桯聽廳郢浧廷艇霆贏籯蜓瀛嬴壬挺梃鋌莛珽脡
ㄌㄛ	俞兪愉踰隃貐愈逾緰揄榆楡瑜偷媮歈渝瘉輸羭鄃覦觎喻喩諭窬蝓偸窳瘐毹毺氀
ㄌㄛㄍ	谷俗欲浴裕慾瀆鵒束讀贖藚匵嬻櫝殰椟牘犢讟䢱韇黷竇
ㄌㄛㄥ	用庸傭滽鄘誦涌通痛勇踴墉牅恿慂勈牗蓉松頌訟容溶鎔穃踊鏞舂樁銅筒甬俑蛹湧筩摏憃
ㄌㄨ	首道導慆蹈滔陶蜪條絛鯈稻誘牖綯鞗鰷舀搯謟韜縚弢匋萄掏騊鎥䱔
ㄌㄨㄍ	育毓淯堉篴覿儥迪抽笛滌昱煜莜蓧蓨蓚袬苖
ㄌㄨㄥ	融彤赨肜曧
ㄌㄚㄨ	姚桃珧佻窕挑跳咷逃迯誂恌鞉軺洮駣銚祧眺覜頫
ㄌㄚㄨㄍ	曜躍燿耀趯翟籊糴鑃藋糶跃
ㄌㄚㄧ	也他施炧灺葹訑弛胣鉈扡拖柂拕匜迆酏迤袘椸㢮蛇虵馱駝跎詑沱陀移迻哆㢋侈袲紽它佗鴕鸵鮀
ㄌㄛㄧ	橢惰隓鬌媠嫷
ㄌㄝㄉ	驖鐵
ㄌㄚㄉ	世枻泄緤裔曳勩洩拽絏貰抴詍靾渫
ㄌㄛㄉ	兌說税蜕説棁兊銳涗蛻悅脫鋭帨侻恱悦兑閱閲駾奪挩涚敚稅毤
ㄌㄝㄋ	-
ㄌㄚㄋ	延筵誕鋋蜒郔綖埏挻涎羡鯅脠
ㄌㄛㄋ	㕣船鉛緣蝝沿兗鈆
ㄌㄧ	尸屍鳲屎桋痍䧅
ㄌㄜㄧ	夷姨侇彞彜彝𦇚𢇏𧤋
ㄌㄨㄧ	水氵
ㄌㄧㄉ	矢失佚昳袟䠶屑溢逸軼室迭臷肄隸瓞泆跌眣胅鎰佾欥
ㄌㄜㄉ	曃逮棣隶銕
ㄌㄨㄉ	出術述沭怵聿术朮秫怷鉥訹腯㤕窋
ㄌㄧㄋ	申神伸畋電引身田甸靷佃蚓呻紳朄
ㄌㄜㄋ	胤酳眹
ㄌㄨㄋ	川順顺遁循巡豚盾遯鬊馴紃楯揗
ㄌㄚㄅ	葉褋蹀韘疊叠疉疂𤴁枼鍱蝶牒堞喋諜揲鰈偞屧
ㄌㄚㄇ	談炎剡琰睒棪賧焱緂錟欻歘舑𦵹䪜阽恬檐簷煔鬵簟惔忝餤驔燂掞苫燄淡倓啖覢裧燅閃闪甜舔閻櫩壛餂爓
ㄌㄜㄅ	習䌌鰼沓踏錔漯襲隰誻眔遝嚃謵槢騽褶溼蹹
ㄌㄜㄇ	冘邥鈂淫婬潭憛尋潯鱘鄩蕁審瀋覃譚蕈曋萏窞啗㸒霪鐔嘾禫撢鱏瞫燂驔忝恬甜舔忝舔鬵

ㄖㄚ	呂閭櫚攄慮虜驢廬壚旅𧆨盧瀘轤艫櫨罏爐鑪廬籚纑顱臚蘆鑢勴濾儢魯櫓撸鹵蓾侶梠鋁郘膂膐玈𠜲
ㄖㄚㄍ	落路硌潞露蕗璐雒吒洛簬絡咯烙酪駱鴼珞略賂輅簵鷺虩亞啞婭丫
ㄖㄚㄥ	英量糧良浪㝗硠悢琅瑯酿閬狼梁粱樑渿兩諒亮廊涼朗障泳倞掠粮俍桹稂蜋螂筤郎踉埌輛蜽魎凉輬辌
ㄖㄜ	里裡悝理狸俚倈徠裏李萊騋鮪涘俟竢眙笞鯉梩貍𠩺嫠孷釐厘氂犛漦恥耻吏來逨崍庲斄郲
ㄖㄜㄍ	力勒肋勅敕遫侙趩飭仂扐阞泐朸賚赉勑
ㄖㄜㄥ	夌陵棱綾㥄稜淩凌蔆菱蓤琌
ㄖㄝ	麗驪鱺孋邐丽酈荔詈儷攦欐劙攭
ㄖㄝㄍ	歷礰靂瀝櫪歴秝厤曆磿
ㄖㄝㄥ	令零舲聆坽泠翎瓴另嶺騁鯪靈灵軨嶸逞嚶嘤瑩苓領鶯鸚罌頂町亭停葶楟顁鉦証整竀綻禎偵赬檉蛏蟶霝蘦伶囹玲笭蛉鈴鴒齡冷𦉢𧕅
ㄖㄛ	婁屢偻篓簍僂樓鏤陋螻蔞縷缕貙塿僂膢嶁嵝摟瘻鞻髏
ㄖㄛㄍ	握渥偓菉祿录菉禄趢錄綠緑騄剝䚄䰁鹿簏蔍鏕蹗轆睩喔幄麓漏瘺嗀腛彔盝琭㯟録籙箓逯摝漉䍡犖碌磟䃙
ㄖㄛㄥ	龍寵嚨龐巃朧瀧礲槞櫳蠬壟聾隴凍籠瓏孌弄蘢礱蠪
ㄖㄨ	留廇瘤榴鶹溜騮塯骝畄霤老珯硓懰瀏流旒聊柳栁铆鉚寥轇瘳雕罶卯茆窌峁駠劉琉牢烋坳翏鏐蟉憀飂嫪勠漻摎醪嘐鄝
ㄖㄨㄍ	六陸蓼穋蓫僇戮滀坴稑鯥
ㄖㄨㄥ	隆癃嶐
ㄖㄚㄨ	孝勞劳捞撈遼繚橑瞭燎忉憭潦料僚膋熮尞嫽寮轑簝蟟獠鷯膫敹了
ㄖㄚㄨㄍ	礫療櫟翯躒轢濼泺䟏
ㄖㄚㄧ	羅蘿罹鑼锣螭縭離攡蘺璃籬拸籮箩离魑醨灕玀猡
ㄖㄛㄧ	臝鸁虆蠃羸蓏倮裸蔂騾骡螺
ㄖㄝㄉ	栵𢗊軋
ㄖㄚㄉ	列裂蛚瀨厲剌賴攋癩癞洌蠆囆烈冽籟藾獺颲茢例㾐勱勵礪癘蠣糲
ㄖㄛㄉ	脟輟缀捋鋝埒酹劣
ㄖㄝㄋ	練輦鄻楝湅鍊蓮煉斓斕
ㄖㄚㄋ	連漣裢槤聯瀾蘭爛鴳鸇梴闌欄攔韊爤讕璉
ㄖㄛㄋ	亂巒鸞鑾銮戀欒䜌灤灓臠攣彎灣卵
ㄖㄧ	利痢體禮黎藜菞犂鵹鯬黧履砥鱧穉羝豊梨蔾犁䔣
ㄖㄜㄧ	淶（蠡劙攭ok）
ㄖㄨㄧ	雷靁藟累磊崴壘纍絫𣚎㹎罍樏欙畾櫑櫐嫘㶟讄鸓礨磥儡儽縲漯耒誄
ㄖㄧㄉ	慄戾悷捩唳蜧栗溧抶瑮盭綟
ㄖㄜㄉ	涖乙劜沴莅蒞钇釔
ㄖㄨㄉ	律淚類率筆纇蘱繂膟
ㄖㄧㄋ	憐轔鱗麟瞵鄰粼疄粦燐繗獜㷠驎甐磷遴橉嶙閵藺躪
ㄖㄜㄋ	吝悋𠯌恡
ㄖㄨㄋ	侖論崙淪沦輪菕惀倫伦綸掄睔蜦
ㄖㄚㄅ	躐巤鬣儠擸邋臘壓獵呷押蠟
ㄖㄚㄇ	覽览爁攬擥藍蓝濫懢諂讇岩廉鐮簾擔聸獫蘞斂殮歛籃襤㜮溓熑磏鎌奩
ㄖㄜㄅ	立馽笠搚粒苙㕇拉
ㄖㄜㄇ	林琳綝箖晽婪臨壈貪嗿廩凛檩霖黕淋稟惏郴懍㐭𢈺癛廪禀凜琛

ㄉㄚ	土吐社杜肚圖徒跿宁佇竚羜苧苎紵貯杵樗躇荼除蒢者都賭堵陼𦑥諸藷豬帾蝫蠩瀦楮闍褚煮覩箸筯睹渚屠曙瘏哲儲赭篨劯櫧
ㄉㄚㄍ	石妒度渡澤蹠蠹蠧橐𣃈著託侘馲籜署尺擇檡炙柘碩剫鼫祏跖磔妬斫拓遮摭辵辶乇托宅咜詫秅㓃坼拆𣔳着
ㄉㄚㄥ	上丄尚尙淌耥黨党戃讜嘗裳常棠堂嘡镗當襠倘腸肠杖章遧漳傽彰鄣長镸粻張脹漲悵怅鬯璋惝曭掌丈仗螳敞厰帳鏜𢠵𢢌宕樟獐鱨償儻攩擋璫矘瞠䟫餦韔萇倀賬棖枨場畼暢撐撑
ㄉㄜ	之芝止芷阯趾砋志持臺檯籉治旹時恃待蒔莳侍戴蛓螅市㧊沚蚩滍塒埘嬯祉峕洔峙畤庤痔跱偫誌戴
ㄉㄜㄍ	職織得淂德識直值値置陟特植寔湜䙷稙埴殖惪犆戠膱樴幟熾炽騭
ㄉㄜㄥ	蒸篜烝登證鐙隥鄧簦橙承氶㞼丞拯成鋮朕幐胜郕栚徵懲澄蹬燈撜等脀
ㄉㄝ	知智箎篪褫是提騠帝締蒂揥啇緹媞豸題踟諦啼蹄禘蜘諟隄惿鞮醍鍉堤偍蝭鯷踶禔卮廌磾
ㄉㄝㄍ	適躑擲謫擿嫡鏑蹢滴摘讁瓋隻
ㄉㄝㄥ	正征佂鉦钲政怔貞楨浈湞程珵誠奠丁汀訂釘朾打钉定聢綻鼎城盛鄭䞓呈裎酲
ㄉㄛ	朱珠殊誅株鴸趎洙斗枓紏斢䚵注柱殶紸樹廚橱投豎竪䝂鬥主駐驻姝躕殳馵豆逗浢鬬脰頭裋袾侏蛛鼄跦邾銖祩麈罜炷註拄鉒住黈壴尌澍㕑兜篼
ㄉㄛㄍ	獨濁觸斶贕屬𣀈蠋燭囑灟諑斲鬭斵蠋躅啄琢咮椓禿秃蜀臅歜襡韣䪅髑噣斀鐲镯斸劚欘钃䠱豖䐁㧻涿瘃
ㄉㄛㄥ	東重踵棟涷蝀鍾董動衝鶫鶫同洞峒迵衕冢塜鐘桐詷挏恫貒僮童橦潼穜罿尰種冢塚妐湩偅腫慟瞳憧幢撞侗桶鮦狪
ㄉㄨ	州洲舟輈繇壽躊儔壔檮梼濤禱嶹懤受授讎紂周凋惆週椆翢綢調蜩鳥蔦胄褭疇鵰啁睭裯酎彫幬帱售翿魗侜醻擣搗酬酧冑綬帚箒雔犨犫籌譸鑄燾肘疛討盩島婤賙輖稠琱錭禂宙紬䩜籀嘄
ㄉㄨㄍ	祝築晝竺竹筑柚孰毒逐軸儵倏淑鬻趠篤俶柷倜焂纛熟塾茿粥鬻舳
ㄉㄨㄥ	冬終中忠沖仲忡种眾潀衆充統珫蟲螽戇疼衷虫䖝衶戇贛
ㄉㄚㄨ	刀刂召詔蛁劭招沼齠迢祒怊虭紹佋袑超韶鼗邵炤弨刁叨饕饀侄苕兆晁烑朓朓宨到倒肇朝嘲潮鼂𪓙昭照趙旐盜貂鞀鼦㲈垗吊𨑩盄掉
ㄉㄚㄨㄍ	卓踔悼倬焯櫂汋灼釣酌濯逴綽罩勺芍弔的菿杓旳妁靮魡擢雿戳禚
ㄉㄚㄧ	多誃恀姼趍痑陊奓馳池竾墬地阤杝陁觶
ㄉㄛㄧ	垂倕腄吹炊瑞惴朵剁陲睡菙捶搥箠諈硾棰甀錘埵唾縋膇
ㄉㄝㄉ	折硩浙滯揥蹛墆蝃垤杕寘蔕遰懘撤
ㄉㄚㄉ	大軑鈦钛太汰汏忕羍怛制製逝晣闥噬澨達撻傺帶带螮廗誓哳泰筮簭晢掣彘悊蜇尐炟
ㄉㄛㄉ	綴拙贅歠惙啜祋叕畷錣剟掇啜醊餟䄌梲
ㄉㄝㄋ	靦輾碾㺗
ㄉㄚㄋ	旦但疸妲狚觛邅壇儃善僐磰鱔缮炭展憚嬋婵殫彈譂弹癉戰蟬嘽僤驒丹鱣檀羶膻顫勯襢單幝箪觯襌鼉墠旃廛亶氈嬗氊膳禪樿燀繟闡匰簞褝鄲鱓撣鴠袒坦澶繵皽旜饘擅蟺繕鄯蕆躔纏瀍
ㄉㄛㄋ	專磚鄟甎篿蓴摶嫥塼抟傳轉漙短端顓湍斷断䠪躖舛踳穿遄慱畽鍛踹段毈腶耑剬歂篅褍鍴喘諯輲揣圌剸團縳鏄膞鱄竱褖瑑篆腞
ㄉㄧ	祗鴟低邸觝岻袛底遲雉薙垁涕睇鵜醴澧梯弟娣銻稚荑坻氐泜䓜稺柢弤抵詆牴厎胝蚳疷秪悌第稊苐綈遟墀謘阺洟缔締
ㄉㄜㄧ	絺黹
ㄉㄨㄧ	追誰鎚堆推頹蓷錞鵻騅隹嶊䳡錐魋𧮓椎顀碓陮槌隤穨頽蹪憝譈雈
ㄉㄧㄉ	至致駤替銍厔庢桎挃嚏咥輊耋秩祑柣窒疐豑緻蛭郅姪絰懥紩袠翐釱剃
ㄉㄜㄉ	質摯鷙轍澈徹贄贽鑕躓懫驇屮飻餮
ㄉㄨㄉ	墜退突對懟怼隊轛黜絀咄呪咒䛆
ㄉㄧㄋ	真眞瑱填塡愼顛顚滇巔慎鎮窴闐陣陳敶搷鬒瘨稹縝黰瞋磌鎭傎蹎齻嗔昚螴紖絼癫癲天
ㄉㄜㄋ	辰震脣唇誫蜄漘軫胗塵晨振典淟畛吞殿甄珍殄疢腆宸脤蜃侲賑娠桭辴籈㐱眕紾袗診疹跈抮趁
ㄉㄨㄋ	春偆蠢屯囤純忳砘頓鶉燉暾惷醇醕敦啍焞諄臀脣漘芚㹠軘沌鈍杶窀肫淳鐓蜳惇萅椿瑃䡅輴準綧
ㄉㄚㄅ	涉闒囁榻鳎鰨蹋蹹耴輒摺慴讋狧毾
ㄉㄚㄇ	憺澹瞻襜贍占霑帖點跕厃詹譫蟾沾鉆玷覘膽薝坫儋幨噡甔佔怗痁站店貼蒧㓠鮎鲇
ㄉㄜㄅ	執縶絷騺答劄蟄畣
ㄉㄜㄇ	甚斟黮踸鍖諶愖煁黮鴆沈沉湛髧葚耽忱醓墊趻揕椹闖酖抌眈紞伔添針曇

ㄙㄚ	所糈素愫胥湑稰壻諝婿瀉疏疎䟽踈些寫嗄穌蘇耍酥
ㄙㄚㄍ	夕汐穸昔惜腊索泝訴愬朔溯槊𧪜遡舃舄潟獡
ㄙㄚㄥ	相湘想霜緗廂爽鷞桑槡纕象像翔詳祥庠橡喪襄鑲顙箱孀
ㄙㄜ	士使仕駛史思罳司伺笥事枲緦鰓腮顋葸諰絲噝咝
ㄙㄜㄍ	色息鄎塞寨砦賽僿㥶熄嗇穡濇赩
ㄙㄜㄥ	-
ㄙㄝ	斯澌纚灑釃屣璽曬躧蹝凘簛廝嘶撕𢓊徙蓰縰簁
ㄙㄝㄍ	皙析淅晰晳蜥
ㄙㄝㄥ	生姓性星睲腥湦省渻騂醒觲觪牲笙甥眚狌鼪晴猩凈
ㄙㄛ	須嬃數薮𢿙瞍傁獀藪櫢鬚叟艘籔盨鑐鯫
ㄙㄛㄍ	速漱續樕粟蔌餗遬嗽欶涑玊
ㄙㄛㄥ	送竦悚雙艭駷聳慫
ㄙㄨ	騷慅搔囚泅羞廋脩修翛㹋繡簫蕭瀟嘯啸秀琇嫂搜捜埽掃蠨鄋溲醙瘦謏袖褏滫篠糔蒐犙歗廀𢯱叜
ㄙㄨㄍ	宿縮摍蓿肅橚鏽鷫督夙謖谡蹜鱐䐹繍玊
ㄙㄨㄥ	宋崧嵩
ㄙㄚㄨ	宵霄肖消喿譟鱢噪劋燥臊小逍笑銷莦蛸繅痟綃捎筲梢稍揱鍬锹驍
ㄙㄚㄨㄍ	削箾
ㄙㄚㄧ	沙紗砂莎娑鯊傞
ㄙㄛㄧ	瑣鎖隨瀡髓蓑簑惢𧴪
ㄙㄝㄉ	暬褻偰楔禼揳
ㄙㄚㄉ	殺杀閷摋樧鎩煞紲辥薛糱媟躠撒繺𦃏𢄌𧜁
ㄙㄛㄉ	雪歲薉刷
ㄙㄝㄋ	鮮鲜霰仙僊躚璇獮狝𤣔䨘癬鱻尟
ㄙㄚㄋ	山疝產産嵼散汕潸綫訕秈線珊
ㄙㄛㄋ	亘選宣喧睻暄蝖酸痠旋孿筭算匴篹祘蒜狻䠣琁
ㄙㄧ	死師师獅私西邃棲洒栖屖細硇
ㄙㄜㄧ	犀兕𧰽
ㄙㄨㄧ	雖綏浽滖榱夊濉脽
ㄙㄧㄉ	四駟肆悉瑟蟋恤䘏泗膝柶虱蕼肂蝨槥櫘檅橞
ㄙㄜㄉ	-
ㄙㄨㄉ	㒸遂璲禭鐩檖穟隧帥粹蟀碎卹繐燧襚旞篲轊睟祟戌銊䢦琗
ㄙㄧㄋ	辛莘新薪噺信訊甡筍栒峷囟顖䒖卂汛訊讯
ㄙㄜㄋ	侁先駪洗毨跣銑姺詵兟
ㄙㄨㄋ	孫蓀狲峻鵔濬璿旬詢珣郇浚飧隼埻准損迅遜愻巽簨
ㄙㄚㄅ	燮翣歃喢萐
ㄙㄚㄇ	彡衫杉芟銛韱孅瀸攕讖摲
ㄙㄜㄅ	澀颯卅
ㄙㄜㄇ	三心忄摻糂糝森穼

ㄓㄚ	楚憷礎初愴且苴祖袓沮靻組駔菹葅阻徂鉏姐瑕霞粗霞鋤蛆𠭯殂租蒩虘樝楂猹查 査柤抯罝咀跙趄狙齟疽砠坥雎鴡岨俎詛助耡觕麤疋蔬梳
ㄓㄚㄍ	作做鵲借斮藉錯碏唶踖趞蜡耤籍厝逪醋矠措簎跡迹乍詐苲齚迮鮓咋笮拃柞筰怍昨酢飵祚胙阼莋
ㄓㄚㄥ	將鏘酱锵糨漿蒼臧藏臟葬壯床匠鶬滄沧狀牆墙倉瑲鎗槍蹌牄跄搶戧創刱剏瘡凔爿斨獎蔣奬醬戕墻廧嬙檣薔妝莊裝牀牂䍧贓贜
ㄓㄜ	子耔孜字牸仔采採彩綵菜茲兹玆滋慈嗞磁嵫𢦔載𣒭栽哉在再材災梓豺裁戺剚颸偲菑宰滓烖鼒胾倳孳財鎡甾淄葘菑緇缁錙輜蚝猜纔
ㄓㄜㄍ	則測则测惻廁側侧賊稷畟䳭萴齰
ㄓㄜㄥ	曾罾僧矰憎增蹭甑層橧繒贈鄫
ㄓㄝ	此雌泚玼呰紫鮆柴茈訿奚貕螇訾佌庛䳄跐貲髭頿疵骴呲齜飺胔眥㧘祡髊眵鄑
ㄓㄝㄍ	績積策筴敵責磧簀幘帻朿刺莿債嘖皟賾蹟漬冊柵刪删脊瘠鶺膌蹐𧻕𧧒塉
ㄓㄝㄥ	青靑清圊精淸情睛箐靜狰爭箏諍筝淨錚铮旌旍井阱靚靓崢晶妌穽浄竫蜻菁請凊靖綪
ㄓㄛ	取陬娵郰娶黀聚驟骤鄹走湊奏輳揍辏鶵芻蒭鄒趨犓騶諏趣腠掫緅棷菆雛嗾
ㄓㄛㄍ	足促浞跼蔟哫族簇鷟擉鏃瘯捉誎
ㄓㄛㄥ	從縱樅瑽鏦摐總緫蹤捴蔥聰傯叢藂豵鬷匆窗窻牕䆫悤怱驄葱摠蟌㚇朡騣鍐艐惾椶稯从囱囪𡆧蓯苁嵷葼
ㄓㄨ	早草皁造曹唕槽遭糟酋遒就憱僦鷲𪆩秋啾湫楸鰍愁酒爪鶖漕縐齺蝤枣棗蚤緧鰌慥簉螬傮皂唣萩揫愀甃抓㕚艹艸
ㄓㄨㄍ	寂戚慼傶學泶澩燢蹙踧䠓蹴鼜鏚顣蔋諔裻鼀竈灶
ㄓㄨㄥ	宗崇綜琮崈
ㄓㄚㄨ	操鄵鷦巢䜈璅鄛漅巣隟憔穱悄峭釥藻教噍譙焦樵瞧膲嶕懆澡璪繰趮躁燋僬潐醮蕉剿勦薻俏哨誚抄訬
ㄓㄚㄨㄍ	鑿雀爵皭糳嚼爝灂釂穛
ㄓㄚㄧ	左佐差磋嗟蹉瑳嵯瘥溠苛菏賀槎鹺䁟叉杈釵齹𪘓𪙐
ㄓㄛㄧ	坐衰挫銼觜痤侳夎蓌莝剉脞䂳髽座
ㄓㄝㄉ	察竊縩詧瘵截札扎
ㄓㄚㄉ	祭蔡際穄囋
ㄓㄛㄉ	絕絶毳撮繓最㝡蕞嘬蕝脃脆膬竁橇
ㄓㄝㄋ	前煎淺鬋翦湔揃剪箭琖盞醆剗濺鏟羼
ㄓㄚㄋ	餐飡遷潺踐賤諓慚巑餞粲俴殘棧桟瓚錢钱贊讚讃饡劗鑚櫕攅燦戔浅帴箋牋籛䙴孱僝轏
ㄓㄛㄋ	荃爨撰纂泉臇竄全詮譔攢纘酇鑽欑钻牷痊筌銓輇雋鐫縓篡悛饌砼仝
ㄓㄧ	次茨咨薋姿栥笫齊濟济済齋擠挤躋薺隮齌虀悽自粢資諮淒萋恣泲姊柿蠐佽穧懠秭緀艩臍劑嚌癠齏齎霽齍儕姉裚胏柹䪠絘餈䆅
ㄓㄜㄧ	凄妻祈郪
ㄓㄨㄧ	唯崔摧檇罪嶵漼褱縗趡催捘脧睃
ㄓㄧㄉ	七切即卽節櫛疾嫉蒺漆楖堲叱桼柒楶㮞
ㄓㄜㄉ	-
ㄓㄨㄉ	卒猝悴踤翠賥誶萃醉倔滑茁瘁崒捽倅啐淬焠顇卆椊㯜枠
ㄓㄧㄋ	千仟親瀙襯進璡津盡晉秦溱嗪臻榛蓁螓倩蒨輤戩藎荩燼阡芊搢縉榗贐寴亲櫬秊𨛲刋
ㄓㄜㄋ	存薦荐栫洊齔齓
ㄓㄨㄋ	尊遵逡俊駿寸忖村邨畯鱒蹲鷷噂譐儁焌餕夋竣㕙踆樽繜僔撙鐏刌僎朘
ㄓㄚㄅ	疌婕捷啑箑緁踕挾接楫檝踥協协浹寁妾椄睫臿插鍤扱菨
ㄓㄚㄇ	斬漸磛槧慙嶄鏩殲纖毚鑱劖攙欃儳讒谗酁僉瞼匳驂慘寖浸潛灊酣邯僭熸僣憸譣尖㦰鑯瀐暫蹔塹蔪斩
ㄓㄜㄅ	緝揖集雜葺洽濕濈戢輯輯匝搭荅嗒慹蓻帀咠襍
ㄓㄜㄇ	侵參参縿幓𠫰驂滲慘嵾槮蔘寢寝寑㑴寖浸綅譖憯岑祲蚕蠶駸噆簪鋟锓兓朁鐕沁

ㄍㄚ	下丅古枯詁蛄故姑苦鴣居崌鶋車庫褲夏去袪魼詓紶鼁虛虚簴驉墟家鉅距蕖秬假瘕蝦遐顧鼓皷瞽扈蔰據躆遽辜胡喖湖戶戸鈩詎暇踞壺廈厦粔虡筥莒葭賈蘧琚锯罟盬䀇沽橭楛祜岵怙酤錮鬍蝴葫瑚鶘餬裾据倨鋸椐腒股羖蠱滬雇僱鳸互枑沍呿祛麮豦籧鐻璩醵嫁稼叚蝦鍜碬虾嘏豭猳赮騢斝芐價檟渠拒歫痼茄伽
ㄍㄚㄍ	各客揢佫閣固涸卻腳濩郭漷貉綌狢臄劇𢓜格胳袼恪骼愘觡垎喀衉𡭴却郤郄戟橶丮隙貈挌彍彉
ㄍㄚㄥ	行坑抗杭沆吭闶航慶羌姜康彊懭庚粳更峺鞕梗郠羹京鯨景竟競岡剛棡掆堈焵罡強繈强衡胻蘅卿哽慷鏡镜亢迒肮骯頏洸伉忼阬綱犅鋼畺繮韁橿壃疆僵薑繦襁蜣境滰憬勍黥鯁綆埂賡㝩穅糠荇桁珩绗絎鵆杏
ㄍㄜ	其亓丌唭欺濝騏䫏騹期箕戒己邔忌改起紀姬駭骸旗麒玖裘該荄胲輆賅賌该齒鬿棋淇碁亥孩痎咳㤥侅垓姟畡晐陔絯核𣇳誡械駴祴基璂朞稘萁諆倛僛魌棊琪祺綦惎諅妀記誋跽屺杞芑糦饎𩟄巂觿鑴
ㄍㄜㄍ	刻硋閡阂勀革棘極殛蝍亟欬劾𦑜克尅剋愅覈㥛襋夨仄𣅔昃
ㄍㄜㄥ	亙堩緪絚䱭揯恒恆兢姮
ㄍㄝ	支枝鳷歧芰豉枳搘繼雞只係翅謑蹊膎蒵氏祇紙岐谿鸂企解圭佳娃奊詿邽觟眭罫街掛鞋褂珪窐系溪忮跂㜎豀鼷騱徯傒鷄肢蚑𢺵頍伎技屐軹咫胑坁扺疧軝蚔舐懈繲蟹嶰邂獬㥟枅蹞
ㄍㄝㄍ	擊翮瀣薤鞷闃阒隔鵙毄墼轚繫鬲搹滆膈䣓覡塥䃒茍𠷜
ㄍㄝㄥ	耕徑俓径經輕莖幸婞悻形刑荊型耿敬驚荆𦮓㓝邢郉磬頸鵛炅熲頃穎颖肯肎涇褧巠逕剄烃烴𥥻陘陉娙脛踁勁鑋硜誙牼殸䡰罄謦儆擏憼警擎檠侀硎鉶鈃倖涬鏗惸硻
ㄍㄛ	侯候喉翭餱糇鍭睺口叩驅軀躯駒拘苟鉤雊夠泃劬構后詬郈厚具俱篌絓卦袿畦桂筀閨規闚窺矩榘駏瓜狐孤弧菰泒姱寡屨篐箍寠絇猴矦𠊱𦂐𨩀衢鼩垢鴝樞怐句佝遘狗耇跔篝覯觏笱窶冓韝瓠罛鸜躣呱苽觚軱夸誇跨荂刳挎袴絝绔槬摦楀萭踽臞勾耉痀枸朐軥袧敂竘媾搆購溝扣釦寇冦滱逅姤倶椇區区彄摳嶇敺巨柜姖緱耟苣炬蚷齲蝺竧氍
ㄍㄛㄍ	曲哭轂輂角捔䇶彀局廓鞹穫懼斛穀㯏桷槨椁鞟䀠瞿欋矍攫匷玃蠼蠷躩虢蒦韄鑊瓁擭護彠頀彟擴狊湨鶪确愨殻瑴榖縠觳觫㝅鷇挶梮
ㄍㄛㄥ	工空舡崆銎倥箜江紅虹扛功邛攻蛩恐鞏共公忪孔鴻洪娂硔谼垬硔巷澒傾煢瓊藑光桄晃胱熿黃黄潢橫廣礦穬瀇璜曠簧狂俇匡哐筐控絖侊觥蟥觵獷壙纊懬冏囧臩臦恇眶框誑潁顈頴颕冋坰詗駉扃䁝奣絅泂迥檾煢講項恭訌嬛貢䲨悾椌杠矼跫廾拱拲供龏龔輁鬨港闀𡉉㱿殼埆釭
ㄍㄨ	九仇訅訄鳩軌朹勼究尻咎晷巧考糗楢皓晧皜浩皋臯嘷睾嗥求救𧚍犰蛷丘邱久怪舊龜昊叫恢詼膠廫廖杲顥龜𣪘𡧌簋匓廄頯逵頄馗宄氿匭厹叴艽鼽虓灸疚㝌柩羑蚯球捄逑銶絿俅賕觩臼桕舅匶鮭刲奎跬挂哇罣瞡韭栲樛櫜韟攪鼛臭溴皐槔皞皡丂攷㱙韮觓訆嘂赳醜奅嚙
ㄍㄨㄍ	覺嚳告鵠鞠蘜掬菊椈踘鞫𩍸國簂虯糾纠繆璆酷梏彧腘馘聝蟈膕匊婅誥郜牿窖麴斅礐鷽
ㄍㄨㄥ	躬窮藭降絳夅洚宮宫弓芎閎穹厶厷肱弘泓宏竑紘纮鞃憌
ㄍㄚㄨ	高槁縞喬碻篙驕嬌篙憍蟜矯䚩搞僑蹻鄗橋犞毫膏狡蛟姣郊效佼餚殽交晈鵁皎鉸澆効羔翹礉徼撟豪皦曒肴淆郩崤糺荍傚鎬鷮暠稿薧犒敲壕濠譹㚠鐈敿譑嶠趫繑敫邀憿竅墽釗茭鮫咬骹烄絞挍恔校爻敎髐磽墝鉊梟鄥鄡齩
ㄍㄚㄨㄍ	鶴鸖繳激噭較䅵屩撽䡈隺搉確榷檄皬㿥
ㄍㄚㄧ	歌哥謌滒可何坷珂蚵河軻柯荷奇竒鵸剞齮寄碕崎騎牁牱笴加痂架嘉鴐迦駕羈羇綺琦錡锜珈個箇哿掎畸踦攲觭个枷耞欹攲
ㄍㄛㄧ	果課戈過撾檛禍媧騧渦濄跪詭虧薖垝蜾裹褁划堁輠踝夥髁錁锞冎咼瘑剮喎鍋蝸緺媯科犐佹恑蛫顆俰
ㄍㄝㄉ	介价尬蚧岕界契猰絜㝣禊䤿潔缺㓞挈鍥瘈緳疥芥紒齘訣
ㄍㄚㄉ	曷葛褐渴鞨揭朅獦竭偈轕愒丐匄𠣏𠣣磕蓋桀傑椉杰割聒害瞎幰蠥鎋蘮憩舝孑佸括适秮秳𣴠喫匃擖毼蝎鶡渇楬碣羯犗轄豁彑冱罽瀱猘訐
ㄍㄛㄉ	月會闕劊外舌話活咶夬趹駃快鴃玦袂觖決决膾獪儈鱠鄶蕨筈闊阔檜蹶厥獗劂鱖蟨噲氒栝髺刮懖欮蟩橛撅嶡廥旝澮襘禬繪鬠睿叡劌𧥎𨜫鄇𠋫鸹鴰
ㄍㄝㄋ	見閒譋覸瞷嫺間间簡简遣肩睍僩僴橌蕑閑澖癇痫豜俔繾猏顅現现莧幵趼汧蚈雃譴瞯嫻柬暕揀幻艮齦豤墾懇恳痕佷很狠釿靳
ㄍㄚㄋ	干旰杆軒涆罕鳱岸婩赶趕靬搴褰攐謇諫蹇寒姦葌乾建韓羨肝菅愆餰騫澗撊腱竿骭睆鯇衎翰瀚哻鼾頇旱睅駻虔榦忓玕矸奸姧飦䄭稈秆皯刊栞虷邗扞閈汗馯釬悍捍倝幹簳鶾侃諐看攓囝䇂鞬犍騝揵健楗鍵键件镟鏇
ㄍㄛㄋ	元玩刓患毌貫完捖脘冠筦莞沅鲩岏抏眷睠蜷捲錈腃管館倌關关權顴齤䠰阮頑顽蚖芫邧魭頑园忨翫謜愿莞款欵拳雚觀观獧矔官綰圈圏原嫄源黿縣懸悹娟涫盥斡卷踡啳澣寬寛髖丱鬈萑鸛蠲鞙祼灌串筦狷絹涓睊逭棺琯痯錧爟瓘蠸䟒鱹古勸摜慣窾萈宦棬倦惓勌豢㹖綣裷券垸浣輐梡豲獂羂
ㄍㄧ	脂示礻沶指兮疞計稽嗜啟棨皆偕階鍇諧堦湝視眎揆喈祁旨恉笄盻飢几虮耆卟启綮晵諡鮨鰭鬐䭫机肌麂楷稭眂薊𧾯魝
ㄍㄜㄧ	豈磑开開冀懻驥骥幾機蟣鐖嘰叽鞿璣玑譏旂饑饥覬敳凱畿頎騤愷塏闓鎧磯禨穖穊刉圻肵蘄
ㄍㄨㄧ	懷壞櫰瀤褢乖媿魁騩葵暌歸蘬鬼愧塊瑰嵬隗磈癸戣睽傀瘣螝廆槐餽巋夔瓌匯臮卼
ㄍㄧㄉ	吉結拮结姞棄弃詰頡佶屆闋揩蛣狤趌洁鮚咭襭擷桔袺髻劼秸黠鞂頁豷
ㄍㄜㄉ	氣愾気既慨溉漑概旣暨乞紇屹疙器气吃訖杚旡蔇嘅洎垍戛戞嘎恝瘛痸
ㄍㄨㄉ	屈掘淈崛鶌窟喟蒯匱橘樻潏貴撌瞶瞆骨蓇憒詘饋汩抇季悸僪獝繘劀譎憰鐍齕鶻搰猾蕢簣櫃柜鞼繢缋凷𠜐胃媦煟蝟彙尉蔚𤈫熨藯褽胐堀鈯誳廐厩嘳
ㄍㄧㄋ	臣茝堅悭慳賢礥牽岍弦衒矜緊紧炫挋臤腎掔繭襺蠒畎鉉絃詃誸蚿螼嚚
ㄍㄜㄋ	根限恨跟硍𥃩謹瑾槿勤懃斤觔近芹饉鄞堇巾墐菫覲觐筋卺巹僅殣廑厪瘽慬㢙垽
ㄍㄨㄋ	困悃閫菌綑溷昆馄餛崑菎鵾髡髠窘君侰莙涒群鯀鲧鰥羣玄眩泫袨昡鮌贙均犬鈞匀赹𢓈混箟麇褌輑軍军惲皹皸鄆鼲緄绲袞囷壼壸袀崐琨錕鯤䃂輥焜蔉瘝坤巛甽睏捆梱稇圂慁麕箘攈稛郡裙麏頵渾繉捃攈
ㄍㄚㄅ	盍溘闔阖甲胛鋏頰狹峽夾郏𨻤陝硤陜愜胠韐劫刧怯盇嗑葢榼匣柙狎炠郟梜莢荚匧篋俠㾜劦叶袷极笈
ㄍㄚㄇ	甘劍劒敢噉譀曮瞰檻艦銜嫌蒹監兼谦傔鶼縑儉矙慊鉗檢検泔拑柑箝黚欠芡鑑鑒礛壏㯺臉嗛歉謙鼸郯羬麙㜝
ㄍㄜㄅ	合郃龕泣湇急及馺伋靸忣岌觙十什給蛤級汲姶鞈拾哈盒䢔閤祫跲鉿鮯彶汁芨
ㄍㄜㄇ	今衿吟含芩鈐笒肣岒涔蚙耹金釒崟淦顄咸感葴瑊堿顑頷埳陷坎砍欽艱禁襟噤禽欿憾減枕黔嶔琴雂庈鍼鹹㜝衾錦锦唫函菡涵堪箴擒紺詌唅坅紟靲䘳趛諴緘黬臽錎焰淊餡嵁戡勘磡歁

ㄚ	乎呼垀雽於箊烏鄔噓歔菸瘀淤飫虖嗚歍棜鴉嘑滹罅塢隖
ㄚㄍ	惡噁恶亦夜液赫壑嚇吓謋覤堊郝腋奕帟弈掖奭襫雘
ㄚㄥ	央殃泱映坱羊佯洋徉痒癢羕漾樣鄉曏饗飨香嚮響鴦恙向賞湟養瀁餭皀膷薌郷享亨餉秧佒鞅怏岟盎醠影䵼永泳咏
ㄜ	喜嬉憘歖禧憙嘻㵙熹譆僖娭咍埃欸唉挨醫毉茞郵佑祐誒醫𦣞頤茞顊宧熙噫毐
ㄜㄍ	意憶抑蜮衋鷾醷億檍薏𦺳繶臆
ㄜㄥ	興膺應擤䧹鷹
ㄝ	蠵攜擕酅纗蛙洼恚嶲觽䥴𢤮
ㄝㄍ	益蠲隘軛厄役戹軶扼枙阸阨膉縊搤謚
ㄝㄥ	聲馨嬰纓瀴蘡钁巊熒滎罃攖櫻癭莺鶯
ㄛ	謳甌膒讴歐熰蓲鷗鴎鏂毆嘔漚傴嫗饇臾諛呴于宇竽邘汙紆禹瑀鄅洿羽珝羿華鏵崋嘩雨鴞譁花汙吁戍雩鄠謣杅玗盂芋迂扜圬杇盱訏釫冔污栩詡偊雨驊樺訽蚼姁昫胊煦㖃後楰庾腴斞斔酗嫭騞褕㡏
ㄛㄍ	屋剭矱藿畫砉垼疫劃嗌緎勗旭戄艧貜臒蠖霍靃矐䁨攉獲勗籲箹
ㄛㄥ	雍擁壅噰洶皇徨隍偟惶篁枉汪往尪尫𡯪兄怳貺贶況慌榮營遑鴛鸳廱凰恍匈邕臃癰罋甕兇胷胸恟哅雝灉澭煌艎鍠锽蝗喤旺暀迋詠軦謊慌螢塋謍禜縈饔訩烘瓮翁嗡
ㄚㄨ	夭妖殀㕭䄏芺搖摿㨱摇遙謠謡徭傜暚瑤少標縹漂號猋要曉騕蒿嚆滈腰鷂宎喓葽嘵窯溔榚㝔窔呺枵哮枖祅訞穾䴠膮䍃榣鰩媱窰椃
ㄚㄨㄍ	藥爍鑠葯約籥鑰龠蘥矅𥌉𧢢沃鋈禴燆熇謞嗃藃礿爚瀹
ㄚㄧ	阿呵訶倚鈳陭輢㫊旖戲椅猗漪鼃窐窪瓾䖒禕痾屙㢌疴
ㄛㄧ	為爲寪蔿鄬噅为蒍䦱撝蟡禾委萎逶涹和隳骫餧婑隋墮墯倭婐龢盉痿踒薳
ㄝㄉ	-	
ㄚㄉ	謁藹蔼歇遏堨閼瘞猲喝暍餲頞揠椻
ㄛㄉ	曰穢秽越樾䟠钺戉翽抉吷衛濊薈噦喙彖椽鶨鉞戉狘顪粵𩜌讆躗吼
ㄝㄋ	宴燕酀鷰觾捐顯㬎嚥曣讌韅蝘醼
ㄚㄋ	安晏按案桉焉鄢嫣偃堰漢汉熯傼桓衍嘕暵鰋鞍鷃妟匽郾㫃蔫掀演戭縯
ㄛㄋ	宛畹怨妴婉菀踠涴冤寃琬凶滃𢯲王爰緩援暖蝯轅歡獾猿遠悁湲媛塤圓鬟還还環儇鱞圜縜磒霣㜏繯鐶寰懁擐轘嚾噮敻驩讂懽瞏蠉翾讙園煖猨諼咺諼垣芄諼渙涣苑蜎貆壎鳶鸢奐丸汍肙囗㾓洹狟荁晅烜諠煥換换焕烉喚寏瑗鍰袁榬吅紈夗鵷眢惌䘼捥腕椀碗惋䡝院沇
ㄧ	維倠濰伊蓍鷖嫛翳咿醯医殹繄䃜贀瑿嫕
ㄜㄧ	衣衤依哀豨狶扆偯希睎悕郗稀唏揮暉楎煇
ㄨㄧ	畏隈渨椳威葳淮惟帷遺遗壝回囘洄迴徊恛佪虺違欷晞幃緯圍諱睢韋葦郼鷕煒韡卉芔輝翬廻蛔闈偉瑋韙褘喂餵㟪偎煨猥䗽蜼
ㄧㄉ	一壹曀殪懿噎饐泬鴥慧蟪彗嘒鏏䎚𦒎熭穗遹驈㙪
ㄜㄉ	愛曖薆瑷迄汔扢摡塈潰僾餼闠
ㄨㄉ	罻惠蕙穴血汨位謂慰渭𥈾洫譓譿矞瞲鷸靧僓
ㄧㄋ	因姻咽㧢氤茵珚煙禋洵闉駰矧矤絪烟垔陻堙湮鄄諲歅印婣
ㄜㄋ	殷隱蘟讔恩寅殥瞚欣惞慇昕忻訢焮釁衅舋㥯檃夤螾哂
ㄨㄋ	慍縕蘊云雲沄伝紜魂䰟耘芸墵員鄖韻隕殞駽運鶤纁舜蕣瞬眴尹淵棩𥁕瘟氲氳醞溫昷熅煴褞緼勳勛允鈗熏曛壎燻埙狁畇訓䀢勻盷昀韵筠徇狥殉侚恂箰橁荀迿絢焄暈餫䩵韗緷葷妘抎爋薰獯臐轀薀韞
ㄚㄅ	脅嗋饁馌瘱拹脇㡋腌醃燁曄牐閘靨靥
ㄚㄇ	淹掩晻崦猒厭擫圧压奄玁豔艷渰檿闞閹鹽饜揜弇嚂懕擪黶酓㱃鵪䨄
ㄜㄅ	邑悒邑翕浥挹熠潝唈歙噏闟欱
ㄜㄇ	音暗湆堷諳窨闇飲陰蔭黯熊廕歆喑瘖唵庵黤黭廞侌霒韽愔
ㄨ	幽憂耰鄾懮櫌嚘優优好休鮴狖鬱又有洧栯㈲尤尢肬右友醢手扌悠游遊蝣猶由油怞妯駎獸守狩窈幼蚴泑鴢杳收浟訧褎頮𥁓侑宥痏疣詯灰莠輶呦怮攸麀猷槱卣薅朽咻貅鵂髹茠嗅齅㥑么幺黝窅鼬滺斿逌酉庮梄蕕櫾媼蚘掾鏖䥝
ㄨㄍ	畜搐蓄鄐燠或域惑掝郁囿繣隩臛稸奧薁慉棫罭閾淢窢侐殈澳
ㄨㄥ	雄訇